############ #############
##         #           # #
## ####### ########### # #
##  ######      ### #  # #
## ##      ######## # ## #
#     ####      ### # #  #
#####    ## ###         ##
########### ##############