###############################################################################
  #                                                                          ##
# # ######################################################################## ##
# #                       #############                     ####   #   #   # ##
# ####################### ############# ################### #### #   #   #   ##
# ###      #####      ### #############   ##     ##     ### #### ##############
#  ## #### ##    ####     #     #########    ### ## ###   # #### ###       ####
## ## ##   #  ############# ### ################ #  ##### # ####     ##### ####
## ##  # ### ##       ##### ### ################ # ###### # ############## ####
##  ## #     ## ##### ##### ### ################ # ####   # ############## ####
### ## ######## ##### ##    ### ############     #    # ### #####     #### ####
#   ## #    ###    ##    ###### ###      #   ######## #  ## ##### ### #### ####
# ###  # ## ###### ############ ### ####   #######    ## ## ##### ###   ## ####
# ##  ## ##    ### ############ ### ############## ##### ## #####  #### ## ####
# #  ### ##### ### #    ###     ### ############## ##### ## ######  ###    ####
#   #### #####     # ##   # #####   #     ######## ####  ## #######  ##########
#####    ########### #### # ##### ### ### ####     #### ### ########  #########
##### ############## #### # #####     ### ###  ######## ### #########  ########
###   ###       ####  ###   ############# ##  ######### ### ##########       ##
### ##### #####  ####   ################# ## ########## ### ################ ##
### ##### ######  ##### ################# ## ##########     ################ ##
###       #######     #              #### ##  #############################  ##
##################### ############## #### ### ############################  ###
#           ######### ############## #### ###  ##########################  ####
# ######### ######### ############## #### ####  ########################  #####
#  ######## ######### ############## #### #####  ######################  ######
## ##   ##  ######### ##############      ######  ###################   #######
##    # ## ########## ###########################   ###############   #########
####### ##    ####### #############################   ##########    ###########
#    ## #####  ###### ###############################    ####    ##############
# ##    ######        ##################################      #################
# #############################################################################